0010000000000-
1010000000000-
1010000000000-
1010100000000-
1010101111111-
1010101111111-
1010101111111-
1010101111111-
1000100000000-
1111111111110-