0010000000000-
1010000022000-
1010000033000-
1010100044000-
1010101111111-
1010101111111-
1010101111111-
1010101111111-
1000100000000-
1111111111110-